/people/appointed_role/appointment./people/appointment/appointed_by	people	people
/location/statistical_region/rent50_2./measurement_unit/dated_money_value/currency	location	finance
/tv/tv_series_episode/guest_stars./tv/tv_guest_role/actor	tv	tv
/music/performance_role/track_performances./music/track_contribution/contributor	music	music
/medicine/disease/prevention_factors	medicine	medicine
/organization/organization_member/member_of./organization/organization_membership/organization	organization	organization
/american_football/football_player/receiving./american_football/player_receiving_statistics/season	american_football	sports
/user/narphorium/people/wealthy_person/net_worth./measurement_unit/dated_money_value/currency	user/narphorium/people	finance
/business/company_type/companies_of_this_type	business	organization
/tv/tv_program/regular_cast./tv/regular_tv_appearance/character	tv	tv
/base/popstra/religion/membership./base/popstra/religion_choice/member	base/popstra	base/popstra
/base/x2010fifaworldcupsouthafrica/world_cup_squad/current_world_cup_squad./base/x2010fifaworldcupsouthafrica/current_world_cup_squad/position	base/x2010fifaworldcupsouthafrica	soccer
/government/politician/government_positions_held./government/government_position_held/jurisdiction_of_office	government	government
/computer/programming_language/influenced_by	computer	computer
/base/folklore/mythology/mythical_creatures	base/folklore	base/folklore
/fictional_universe/fictional_character/species	fictional_universe	fictional_universe
/cvg/game_character/games./cvg/game_performance/game	cvg	cvg
/education/field_of_study/students_majoring./education/education/minor	education	education
/people/cause_of_death/includes_causes_of_death	people	people
/base/onephylogeny/type_of_thing/includes	base/onephylogeny	base/onephylogeny
/film/film/runtime./film/film_cut/type_of_film_cut	film	film
/astronomy/star_system/planetary_system	astronomy	astronomy
/film/actor/dubbing_performances./film/dubbing_performance/language	film	language
/base/popstra/organization/supporter./base/popstra/support/supporter	base/popstra	base/popstra
/media_common/dedicatee/dedications./media_common/dedication/dedicated_by	media_common	media_common
/education/field_of_study/students_majoring./education/education/major_field_of_study	education	education
/biology/animal_breed/place_of_origin	biology	biology
/film/film/starring./film/performance/special_performance_type	film	film
/media_common/media_genre/child_genres	media_common	media_common
/base/popstra/celebrity/shops_at./base/popstra/shopping_choice/company	base/popstra	base/popstra
/finance/currency/countries_used	finance	location
/visual_art/visual_art_genre/artworks	visual_art	visual_art
/location/capital_of_administrative_division/capital_of./location/administrative_division_capital_relationship/administrative_division	location	location
/base/x2010fifaworldcupsouthafrica/world_cup_participant/world_cup_team./base/x2010fifaworldcupsouthafrica/current_world_cup_squad/position	base/x2010fifaworldcupsouthafrica	soccer
/food/diet/followers	food	food
/tv/special_tv_performance_type/starring_performances./tv/regular_tv_appearance/character	tv	tv
/people/marriage_union_type/unions_of_this_type./people/marriage/spouse	people	people
/organization/organization_sector/organizations_in_this_sector	organization	organization
/baseball/baseball_team/team_stats./baseball/baseball_team_stats/season	baseball	sports
/award/award_category/disciplines_or_subjects	award	award
/base/yalebase/secret_society_member/belonged_to./base/yalebase/secret_society_membership/society	base/yalebase	base/yalebase
/government/governmental_body/body_this_is_a_component_of	government	government
/people/person/parents	people	people
/user/jg/default_domain/olympic_games/sports	user/jg/default_domain	user/jg/default_domain
/medicine/disease/includes_diseases	medicine	medicine
/biology/animal_breed/breed_of	biology	biology
/olympics/olympic_participating_country/athletes./olympics/olympic_athlete_affiliation/sport	olympics	olympics
/people/person/nationality	people	location
/base/biblioness/bibs_location/state	base/biblioness	location
/location/statistical_region/rent50_3./measurement_unit/dated_money_value/currency	location	finance
/cvg/computer_videogame/prequel	cvg	cvg
/music/genre/parent_genre	music	music
/location/country/languages_spoken	location	language
/film/special_film_performance_type/film_performance_type./film/performance/actor	film	film
/base/thoroughbredracing/thoroughbred_racehorse_sex/horses_of_this_sex	base/thoroughbredracing	base/thoroughbredracing
/tv/tv_genre/programs	tv	tv
/base/thoroughbredracing/thoroughbred_racehorse_color/horses_of_this_color	base/thoroughbredracing	base/thoroughbredracing
/music/group_member/membership./music/group_membership/group	music	music
/film/film_genre/films_in_this_genre	film	film
/american_football/football_player/games./american_football/player_game_statistics/season	american_football	sports
/fictional_universe/fictional_universe/characters	fictional_universe	fictional_universe
/interests/collection_category/parent_category	interests	interests
/business/consumer_product/company./business/company_product_relationship/company	business	business
/film/film/film_art_direction_by	film	film
/base/locations/countries/continent	base/locations	base/locations
/music/artist/label	music	music
/theater/theater_actor/theater_roles./theater/theater_role/role	theater	theater
/people/cause_of_death/people	people	people
/tv/tv_network/areas_served	tv	location
/base/aareas/schema/administrative_area/administrative_parent	base/aareas/schema	base/aareas/schema
/book/book_subject/works	book	book
/base/infrastructure/power_station/fuel_type	base/infrastructure	base/infrastructure
/projects/project_participant/projects./projects/project_participation/role	projects	projects
/medicine/drug_class/drugs	medicine	medicine
/soccer/football_position/players	soccer	soccer
/location/statistical_region/population./measurement_unit/dated_integer/source	location	dataworld
/olympics/olympic_participating_country/olympics_participated_in	olympics	olympics
/common/annotation_category/annotations./common/webpage/topic	common	common
/user/alexbl/honorary_title/titled_person/honorary_title./user/alexbl/honorary_title/honorary_title_holding/honorary_title	user/alexbl/honorary_title	user/alexbl/honorary_title
/food/dietary_restriction/incompatible_ingredients	food	food
/film/film_crewmember/films_crewed./film/film_crew_gig/film	film	film
/fictional_universe/fictional_character/place_of_birth	fictional_universe	fictional_universe
/base/argumentmaps/morally_disputed_activity/instance_of_abstract_moral_dispute	base/argumentmaps	base/argumentmaps
/film/film/other_film_companies./film/film_film_company_relationship/film_company	film	film
/music/genre/artists	music	music
/location/country/first_level_divisions	location	location
/baseball/baseball_position/players	baseball	baseball
/broadcast/artist/content	broadcast	broadcast
/government/political_party/politicians_in_this_party./government/political_party_tenure/politician	government	government
/olympics/olympic_athlete/medals_won./olympics/olympic_medal_honor/country	olympics	olympics
/location/location/street_address./location/mailing_address/state_province_region	location	location
/fictional_universe/character_powers/characters_with_this_ability	fictional_universe	fictional_universe
/medicine/medical_treatment/used_to_treat	medicine	medicine
/people/person/education./education/education/institution	people	education
/business/business_operation/cash./measurement_unit/dated_money_value/currency	business	finance
/royalty/noble_person/titles./royalty/noble_title_tenure/noble_title	royalty	royalty
/base/newsevents/news_reported_event/news_report_s./base/newsevents/news_report/news_reporting_organisation	base/newsevents	base/newsevents
/base/fight/crime_type/includes_crimes	base/fight	base/fight
/tv/tv_series_episode/producers./tv/tv_producer_episode_credit/producer	tv	tv
/film/personal_film_appearance_type/film_appearances./film/personal_film_appearance/film	film	film
/comic_books/comic_book_series/created_by	comic_books	comic_books
/base/patronage/patron/related_client./base/patronage/patron_client_relationship/client	base/patronage	base/patronage
/base/parody/parody/parody_of	base/parody	base/parody
/media_common/dedicator/dedications./media_common/dedication/dedicated_to	media_common	media_common
/broadcast/radio_station/owner	broadcast	broadcast
/military/military_conflict/commanders./military/military_command/military_combatant	military	military
/people/deceased_person/place_of_burial	people	people
/fictional_universe/fictional_character_creator/fictional_characters_created	fictional_universe	fictional_universe
/tv/special_tv_performance_type/starring_performances./tv/regular_tv_appearance/actor	tv	tv
/music/artist/supporting_artists	music	music
/transportation/bridge/locale	transportation	location
/music/artist/contribution./music/recording_contribution/performance_role	music	music
/medicine/drug/legal_status	medicine	medicine
/book/literary_series/author_s	book	book
/tv/tv_actor/starring_roles./tv/regular_tv_appearance/character	tv	tv
/base/contractbridge/bridge_player/second_place_finish./base/contractbridge/bridge_tournament_standings/second_place	base/contractbridge	base/contractbridge
/award/award/presented_by	award	award
/location/neighborhood/neighborhood_of	location	location
/base/localfood/seasonal_month/produce_available./base/localfood/produce_availability/seasonal_months	base/localfood	base/localfood
/architecture/architect/structures_designed	architecture	architecture
/award/award_nominated_work/award_nominations./award/award_nomination/award	award	award
/food/diet_follower/follows_diet	food	food
/religion/religion/places_of_worship	religion	religion
/travel/travel_destination/how_to_get_here./travel/transportation/transport_operator	travel	travel
/education/educational_institution_campus/educational_institution	education	education
/book/author/series_written_or_contributed_to	book	book
/award/award_winner/awards_won./award/award_honor/award_winner	award	award
/medicine/disease/risk_factors	medicine	medicine
/baseball/baseball_team/current_roster./sports/sports_team_roster/player	baseball	sports
/government/political_district/representatives./government/government_position_held/basic_title	government	government
/base/ecology/food_web_member/belongs_to_ecosystem_s	base/ecology	base/ecology
/people/ethnicity/geographic_distribution	people	location
/music/conducted_ensemble/conductors./music/conducting_tenure/conductor	music	music
/medicine/disease/treatments	medicine	medicine
/base/popstra/celebrity/hangout./base/popstra/hangout/business_location	base/popstra	base/popstra
/sports/pro_athlete/sports_played_professionally./sports/pro_sports_played/sport	sports	sports
/architecture/museum/address./location/mailing_address/citytown	architecture	location
/biology/organism_classification/rank	biology	biology
/geography/lake_type/lakes_of_this_type	geography	geography
/olympics/olympic_athlete/medals_won./olympics/olympic_medal_honor/olympics	olympics	olympics
/people/family_member/family	people	people
/base/petbreeds/dog_coat_color/dog_breeds	base/petbreeds	base/petbreeds
/tv/tv_program/regular_cast./tv/regular_tv_appearance/seasons	tv	tv
/tv/tv_program/genre	tv	tv
/theater/play/country_of_origin	theater	location
/olympics/olympic_athlete/medals_won./olympics/olympic_medal_honor/medal	olympics	olympics
/sports/sports_position/players./sports/sports_team_roster/position	sports	sports
/cvg/game_voice_actor/computer_game_voice_performances./cvg/game_performance/character	cvg	cvg
/biology/animal_breed/registered_with./biology/breed_registration/registry	biology	biology
/sports/sports_league/teams./sports/sports_league_participation/team	sports	sports
/military/rank/used_by_services./military/military_service/military_force	military	military
/fictional_universe/fictional_character/gender	fictional_universe	fictional_universe
/education/school/highest_grade_taught	education	education
/education/educational_degree/people_with_this_degree./education/education/minor	education	education
/baseball/baseball_team/league	baseball	baseball
/base/x2010fifaworldcupsouthafrica/world_cup_participant/world_cup_team./base/x2010fifaworldcupsouthafrica/current_world_cup_squad/national_team	base/x2010fifaworldcupsouthafrica	base/x2010fifaworldcupsouthafrica
/military/military_conflict/casualties./military/casualties/combatant	military	military
/computer/software/software_genre	computer	computer
/military/armed_force/personnel./military/military_service/rank	military	military
/royalty/system_of_nobility/titles./royalty/system_title_relationship/title	royalty	royalty
/basketball/basketball_team/roster./sports/sports_team_roster/position	basketball	sports
/base/disaster2/tactic/attacks_of_this_form./base/disaster2/attack_process/attack_event	base/disaster2	base/disaster2
/people/person/place_of_birth	people	location
/cvg/game_series/games_in_series	cvg	cvg
/spaceflight/space_agency/astronauts	spaceflight	spaceflight
/time/event/includes_event	time	time
/base/aareas/schema/administrative_area/capital	base/aareas/schema	base/aareas/schema/earth
/medicine/icd_9_cm_classification/parent_classification	medicine	medicine
/people/cause_of_death/parent_cause_of_death	people	people
/education/university/domestic_tuition./measurement_unit/dated_money_value/currency	education	finance
/people/profession/specialization_of	people	people
/music/musical_group/member./music/group_membership/role	music	music
/media_common/literary_genre/books_in_this_genre	media_common	book
/music/instrument/instrumentalists	music	music
/government/politician/government_positions_held./government/government_position_held/appointed_by	government	government
/sports/sports_team/colors	sports	visual_art
/religion/religious_text/religious_text_of	religion	religion
/organization/role/leaders./organization/leadership/person	organization	business
/fictional_universe/fictional_setting/fictional_characters_born_here	fictional_universe	fictional_universe
/film/production_company/films	film	film
/sports/sports_award_winner/awards./sports/sports_award/award	sports	sports
/base/argumentmaps/abstract_moral_dispute/particular_instances	base/argumentmaps	base/argumentmaps
/people/person/sibling_s./people/sibling_relationship/sibling	people	people
/influence/influence_node/influenced	influence	influence
/book/newspaper_owner/newspapers_owned	book	book
/geography/river/basin_countries	geography	location
/film/person_or_entity_appearing_in_film/films./film/personal_film_appearance/film	film	film
/royalty/order_of_chivalry/recipients./royalty/chivalric_order_membership/recipient	royalty	royalty
/visual_art/art_period_movement/associated_artists	visual_art	visual_art
/film/film/dubbing_performances./film/dubbing_performance/actor	film	film
/user/szaijan/fantasy_football/player/nfl_team	user/szaijan/fantasy_football	american_football
/base/contractbridge/bridge_player/second_place_finish./base/contractbridge/bridge_tournament_standings/first_place	base/contractbridge	base/contractbridge
/military/armed_force/personnel./military/military_service/military_person	military	military
/organization/organization/board_members./organization/organization_board_membership/role	organization	organization
/location/it_province/capital	location	location
/base/contractbridge/bridge_player/first_place_finish./base/contractbridge/bridge_tournament_standings/second_place	base/contractbridge	base/contractbridge
/common/webpage/category	common	common
/medicine/type_of_infectious_agent/diseases	medicine	medicine
/book/newspaper/owner	book	book
/architecture/building/building_function	architecture	architecture
/time/recurring_event/instances	time	time
/base/crime/crime_victim/crime	base/crime	base/crime
/american_football/football_coach/coaching_history./american_football/football_historical_coach_position/team	american_football	american_football
/sports/sports_league_draft/picks./sports/sports_league_draft_pick/team	sports	sports
/base/contractbridge/bridge_player/teammates./base/contractbridge/bridge_player_teammates/teammate	base/contractbridge	base/contractbridge
/architecture/architectural_style/examples	architecture	architecture
/cvg/computer_videogame/characters./cvg/game_performance/voice_actor	cvg	cvg
/olympics/olympic_games/athletes./olympics/olympic_athlete_affiliation/sport	olympics	olympics
/internet/website_owner/websites_owned_new./internet/website_ownership/website	internet	internet
/olympics/olympic_athlete/country./olympics/olympic_athlete_affiliation/olympics	olympics	olympics
/film/film/release_date_s./film/film_regional_release_date/film_regional_debut_venue	film	film
/base/biblioness/bibs_location/country	base/biblioness	location
/organization/organization/spun_off_from./organization/organization_spin_off/parent_company	organization	organization
/government/government_office_or_title/category	government	government
/aviation/airport/hub_for	aviation	aviation
/cvg/cvg_publisher/games_published	cvg	cvg
/government/legislative_session/members./government/government_position_held/basic_title	government	government
/base/wrestling/solo_wrestler_or_team/members	base/wrestling	base/wrestling
/government/government_office_or_title/office_holders./government/government_position_held/appointed_by	government	government
/tv/tv_actor/starring_roles./tv/regular_tv_appearance/series	tv	tv
/education/educational_institution/students_graduates./education/education/major_field_of_study	education	education
/user/alexander/misc/murdered_person/place_murdered	user/alexander/misc	location
/base/saints/saint/venerated_in	base/saints	religion
/film/film/gross_revenue./measurement_unit/dated_money_value/currency	film	finance
/film/film_character/portrayed_in_films./film/performance/special_performance_type	film	film
/organization/organization/leadership./organization/leadership/role	organization	organization
/base/nobelprizes/nobel_subject_area/nobel_awards./base/nobelprizes/nobel_honor/nobel_prize_winner	base/nobelprizes	base/nobelprizes
/tv/special_tv_performance_type/episode_performances./tv/tv_guest_role/actor	tv	tv
/base/americancomedy/celebrity_impressionist/celebrities_impersonated	base/americancomedy	base/americancomedy
/base/activism/organization/area_of_activism	base/activism	base/activism
/organization/organization/involved_in_merger./organization/organization_merger/became_organization	organization	organization
/fictional_universe/character_gender/characters_of_this_gender	fictional_universe	fictional_universe
/people/ethnicity/included_in_group	people	people
/baseball/baseball_player/position_s	baseball	baseball
/american_football/football_coach_position/coaches_holding_this_position./american_football/football_historical_coach_position/team	american_football	american_football
/base/popstra/restaurant/restaurant_choice./base/popstra/restaurant_choice/diner	base/popstra	base/popstra
/baseball/baseball_team/current_roster./sports/sports_team_roster/position	baseball	sports
/base/popstra/company/fashion_choice./base/popstra/fashion_choice/fashion_wearer	base/popstra	base/popstra
/location/country/second_level_divisions	location	location
/sports/professional_sports_team/draft_picks./sports/sports_league_draft_pick/player	sports	sports
/fictional_universe/fictional_character/ethnicity	fictional_universe	fictional_universe
/sports/sports_team/location	sports	sports
/soccer/football_player/goals_scored./soccer/football_goal/point_awarded_to	soccer	soccer
/base/onephylogeny/type_of_thing/things_of_this_type	base/onephylogeny	common
/music/voice/singers	music	music
/film/film/distributors./film/film_film_distributor_relationship/distributor	film	film
/religion/religion/notable_figures	religion	people
/influence/influence_node/peers./influence/peer_relationship/peers	influence	influence
/user/robert/us_congress/house_committee/current_members	user/robert/us_congress	user/robert/us_congress
/sports/drafted_athlete/drafted./sports/sports_league_draft_pick/school	sports	education
/fictional_universe/character_rank/characters_of_this_rank	fictional_universe	fictional_universe
/comic_books/comic_book_series/featured_characters	comic_books	comic_books
/cvg/computer_videogame/designers	cvg	cvg
/medicine/risk_factor/diseases	medicine	medicine
/award/award_category/long_lists./award/long_list_nomination/nominee	award	award
/medicine/drug/active_moieties	medicine	medicine
/film/film/music	film	film
/martial_arts/martial_artist/martial_art	martial_arts	martial_arts
/location/statistical_region/rent50_0./measurement_unit/dated_money_value/currency	location	finance
/base/schemastaging/tv_program_extra/regular_dubbing_performances./base/schemastaging/tv_star_dubbing_performance/language	base/schemastaging	language
/people/person/spouse_s./people/marriage/location_of_ceremony	people	location
/visual_art/visual_artist/associated_periods_or_movements	visual_art	visual_art
/architecture/building_function/buildings	architecture	architecture
/book/school_or_movement/associated_authors	book	book
/theater/theater_character/portrayed_by./theater/theater_role/actor	theater	theater
/biology/animal_breed/registered_with./biology/breed_registration/breed_group	biology	biology
/common/topic/webpage./common/webpage/topic	common	common
/cvg/computer_videogame/publisher	cvg	cvg
/government/politician/government_positions_held./government/government_position_held/governmental_body	government	government
/music/group_member/vocal_range	music	music
/biology/organism_classification/higher_classification	biology	biology
/education/educational_institution/students_graduates./education/education/degree	education	education
/astronomy/celestial_object/category	astronomy	astronomy
/people/person/religion	people	religion
/user/coco/science/concepts_theories/parent_concept	user/coco/science	user/coco/science
/sports/tournament_event_competitor/events_competed_in./sports/competitor_competition_relationship/country	sports	sports
/film/cinematographer/film	film	film
/base/famouspets/pet_owner/pets_owned./base/famouspets/pet_ownership/owner	base/famouspets	base/famouspets
/people/person/employment_history./business/employment_tenure/title	people	business
/tv/tv_program_guest/appeared_on./tv/tv_guest_personal_appearance/episode	tv	tv
/location/statistical_region/gni_in_ppp_dollars./measurement_unit/dated_money_value/currency	location	finance
/base/fight/sports_official/sport	base/fight	sports
/base/popstra/celebrity/breakup./base/popstra/breakup/participant	base/popstra	base/popstra
/location/location/partially_contains	location	location
/people/person/spouse_s./people/marriage/spouse	people	people
/base/popstra/celebrity/vacations_in./base/popstra/vacation_choice/location	base/popstra	base/popstra
/olympics/olympic_participating_country/athletes./olympics/olympic_athlete_affiliation/athlete	olympics	olympics
/aviation/airline/airports_served./aviation/airline_airport_presence/cities_served	aviation	location
/dining/cuisine/dishes	dining	food
/olympics/olympic_sport/athletes./olympics/olympic_athlete_affiliation/country	olympics	olympics
/location/symbol_of_administrative_division/official_symbol_of./location/location_symbol_relationship/administrative_division	location	government
/business/business_operation/assets./measurement_unit/dated_money_value/currency	business	finance
/tv/tv_program/regular_cast./tv/regular_tv_appearance/actor	tv	tv
/book/magazine_genre/magazines_in_this_genre	book	book
/base/schemastaging/tv_program_extra/regular_dubbing_performances./base/schemastaging/tv_star_dubbing_performance/character	base/schemastaging	base/schemastaging
/government/legislative_session/members./government/government_position_held/office_holder	government	government
/base/americancomedy/comedy_genre/comedians_in_this_genre	base/americancomedy	base/americancomedy
/film/film_art_director/films_art_directed	film	film
/education/academic_institution/visiting_scholars_fellows_etc./education/academic_post/person	education	education
/business/employer/employees./business/employment_tenure/title	business	business
/olympics/olympic_sport/athletes./olympics/olympic_athlete_affiliation/olympics	olympics	olympics
/baseball/baseball_player/batting_stats./baseball/batting_statistics/season	baseball	sports
/education/school_category/schools_of_this_kind	education	education
/music/artist/track_contributions./music/track_contribution/role	music	music
/base/localfood/food_producing_region/seasonal_availability./base/localfood/produce_availability/produce	base/localfood	base/localfood
/protected_sites/listed_site/designation_as_natural_or_cultural_site./protected_sites/natural_or_cultural_site_listing/designation	protected_sites	protected_sites
/military/military_conflict/combatants./military/military_combatant_group/combatants	military	military
/tv/tv_producer_type/tv_producers_of_this_type./tv/tv_producer_term/producer	tv	tv
/education/field_of_study/students_majoring./education/education/specialization	education	education
/film/film/production_companies	film	film
/base/saturdaynightlive/snl_cast_member/seasons./base/saturdaynightlive/snl_season_tenure/cast_members	base/saturdaynightlive	base/saturdaynightlive
/computer/programming_language/language_designers	computer	computer
/base/americancomedy/comedy_group_member/belongs_to./base/americancomedy/comedy_group_membership/group	base/americancomedy	base/americancomedy
/location/place_with_neighborhoods/neighborhoods	location	location
/education/university/fraternities_and_sororities	education	education
/base/usnationalparks/us_national_park/state	base/usnationalparks	location
/base/contractbridge/bridge_player/first_place_finish./base/contractbridge/bridge_tournament_standings/tournament	base/contractbridge	base/contractbridge
/education/educational_institution/students_graduates./education/education/specialization	education	education
/location/statistical_region/rent50_1./measurement_unit/dated_money_value/currency	location	finance
/base/contractbridge/bridge_tournament/standing./base/contractbridge/bridge_tournament_standings/first_place	base/contractbridge	base/contractbridge
/government/politician/government_positions_held./government/government_position_held/district_represented	government	government
/government/governmental_body/members./government/government_position_held/appointed_by	government	government
/user/tfmorris/default_domain/signatory/documents_signed	user/tfmorris/default_domain	user/tfmorris/default_domain
/geography/island/body_of_water	geography	geography
/location/country/form_of_government	location	government
/film/special_film_performance_type/film_performance_type./film/performance/film	film	film
/base/aareas/schema/administrative_area/administrative_children	base/aareas/schema	base/aareas/schema
/film/music_contributor/film	film	film
/government/politician/government_positions_held./government/government_position_held/basic_title	government	government
/fictional_universe/fictional_character/appears_in_these_fictional_universes	fictional_universe	fictional_universe
/government/election/office	government	government
/user/robert/us_congress/us_representative/committee_memberships	user/robert/us_congress	user/robert/us_congress
/education/university/local_tuition./measurement_unit/dated_money_value/currency	education	finance
/education/educational_institution/sports_teams	education	sports
/food/dish/cuisine	food	dining
/military/military_combatant/military_commanders./military/military_command/military_conflict	military	military
/aviation/aircraft_type/aircraft_of_this_type	aviation	aviation
/base/events/festival_series/type_of_festival	base/events	base/events
/basketball/basketball_player/player_statistics./basketball/basketball_player_stats/team	basketball	basketball
/business/brand/owner_s./business/company_brand_relationship/company	business	business
/award/award_winner/awards_won./award/award_honor/ceremony	award	award
/base/events/performer/performances./base/events/performance/performer	base/events	base/events
/aviation/airline/focus_cities	aviation	aviation
/base/events/type_of_festival/recurring_festivals_of_this_type	base/events	base/events
/military/military_combatant/force_deployments./military/force_strength/military_conflict	military	military
/american_football/football_team/current_roster./sports/sports_team_roster/player	american_football	sports
/education/educational_institution/mascot	education	education
/film/film/film_casting_director	film	film
/olympics/olympic_sport/olympic_games_contested	olympics	olympics
/base/fight/crime_type/included_in_crimes	base/fight	base/fight
/business/asset/owners./business/asset_ownership/owner	business	business
/tennis/tennis_player/matches_won./tennis/tennis_match/loser	tennis	tennis
/geography/lake/cities	geography	location
/soccer/football_team/current_roster./sports/sports_team_roster/position	soccer	sports
/film/film/directed_by	film	film
/computer/programming_language/dialects	computer	computer
/award/award_ceremony/awards_presented./award/award_honor/award	award	award
/location/statistical_region/gdp_real./measurement_unit/adjusted_money_value/adjustment_currency	location	finance
/visual_art/visual_art_form/artists	visual_art	visual_art
/organization/organization/parent./organization/organization_relationship/parent	organization	organization
/base/thoroughbredracing/thoroughbred_racehorse_origin/horses_from_this_location	base/thoroughbredracing	base/thoroughbredracing
/olympics/olympic_medal/medal_winners./olympics/olympic_medal_honor/country	olympics	olympics
/medicine/medical_treatment/side_effects	medicine	medicine
/base/popstra/celebrity/eats_at./base/popstra/restaurant_choice/restaurant	base/popstra	base/popstra
/tv/tv_program/spun_off_from	tv	tv
/business/business_operation/industry	business	business
/education/educational_institution/parent_institution	education	education
/film/film_set_designer/film_sets_designed	film	film
/tv/non_character_role/tv_regular_personal_appearances./tv/tv_regular_personal_appearance/program	tv	tv
/education/school/lowest_grade_taught	education	education
/film/film_company/films./film/film_film_company_relationship/film	film	film
/base/americancomedy/comedian/comedy_genres	base/americancomedy	base/americancomedy
/government/politician/government_positions_held./government/government_position_held/legislative_sessions	government	government
/medicine/disease/causes	medicine	medicine
/film/special_film_performance_type/film_performance_type./film/performance/character	film	film
/government/governmental_jurisdiction/government_positions	government	government
/medicine/drug/drug_class	medicine	medicine
/government/governmental_body/members./government/government_position_held/district_represented	government	government
/tv/tv_character/appeared_in_tv_program./tv/regular_tv_appearance/special_performance_type	tv	tv
/religion/deity/deity_of	religion	religion
/film/film/prequel	film	film
/base/argumentmaps/original_idea/innovator	base/argumentmaps	base/argumentmaps
/tv/tv_subject/tv_programs	tv	tv
/award/award_presenting_organization/awards_presented	award	award
/tv/tv_actor/starring_roles./tv/regular_tv_appearance/seasons	tv	tv
/book/newspaper/circulation_areas	book	periodicals
/film/film/written_by	film	film
/tv/tv_program/spin_offs	tv	tv
/tv/tv_actor/guest_roles./tv/tv_guest_role/character	tv	tv
/sports/sports_league/sport	sports	sports
/location/location/containedby	location	location
/organization/role/governors./organization/organization_board_membership/organization	organization	organization
/baseball/baseball_player/lifetime_batting_statistics./baseball/lifetime_batting_statistics/starting_season	baseball	sports
/travel/transport_operator/travel_destinations_served./travel/transportation/travel_destination	travel	travel
/location/location/time_zones	location	time
/computer/programming_language_designer/languages_designed	computer	computer
/music/album_release_type/albums	music	music
/award/award_discipline/awards_in_this_discipline	award	award
/people/ethnicity/people	people	people
/periodicals/newspaper_circulation_area/newspapers	periodicals	book
/people/profession/specializations	people	people
/government/political_appointer/appointees./government/government_position_held/office_holder	government	government
/user/robert/us_congress/us_representative/state	user/robert/us_congress	location
/film/film/subjects	film	film
/book/newspaper/headquarters./location/mailing_address/citytown	book	location
/film/film_production_designer/films_production_designed	film	film
/computer/software_genre/software_in_genre	computer	computer
/celebrities/celebrity/celebrity_friends./celebrities/friendship/friend	celebrities	celebrities
/protected_sites/natural_or_cultural_site_designation/sites./protected_sites/natural_or_cultural_site_listing/listed_site	protected_sites	protected_sites
/business/employer/employees./business/employment_tenure/person	business	people
/tv/tv_series_season/regular_cast./tv/regular_tv_appearance/seasons	tv	tv
/olympics/olympic_participating_country/medals_won./olympics/olympic_medal_honor/medal	olympics	olympics
/organization/organization/headquarters./location/mailing_address/country	organization	location
/music/conductor/groups./music/conducting_tenure/ensemble	music	music
/common/resource/annotations./common/webpage/category	common	common
/base/fashionmodels/fashion_model/hair_color	base/fashionmodels	base/fashionmodels
/education/educational_degree/people_with_this_degree./education/education/student	education	people
/projects/project_role/projects./projects/project_participation/participant	projects	projects
/biology/organism_classification_rank/organism_classifications	biology	biology
/base/popstra/celebrity/lived_with./base/popstra/lived_with/participant	base/popstra	base/popstra
/user/szaijan/fantasy_football/position/player	user/szaijan/fantasy_football	user/szaijan/fantasy_football
/tv/tv_writer/tv_programs./tv/tv_program_writer_relationship/tv_program	tv	tv
/theater/theater_genre/plays_in_this_genre	theater	theater
/government/governmental_body/members./government/government_position_held/office_holder	government	government
/award/award_winning_work/awards_won./award/award_honor/ceremony	award	award
/religion/religion/is_part_of	religion	religion
/film/producer/film	film	film
/tv/tv_producer/programs_produced./tv/tv_producer_term/program	tv	tv
/base/twinnedtowns/twinned_town/twinned_with./base/twinnedtowns/town_twinning/twinned_towns	base/twinnedtowns	base/twinnedtowns
/transportation/road/end1./transportation/road_starting_point/location	transportation	location
/base/parody/parodied_subject/parodies	base/parody	base/parody
/government/government_office_or_title/governmental_body_if_any	government	government
/language/language_family/languages	language	language
/tv/tv_program/program_creator	tv	tv
/music/performance_role/regular_performances./music/group_membership/group	music	music
/education/field_of_study/subdiscipline_of	education	education
/music/performance_role/track_performances./music/track_contribution/role	music	music
/broadcast/tv_station_owner/tv_stations	broadcast	broadcast
/base/schemastaging/organization_extra/phone_number./base/schemastaging/phone_sandbox/service_language	base/schemastaging	language
/business/industry/companies	business	business
/base/schemastaging/tv_actor_extra/regular_dubbing_performances./base/schemastaging/tv_star_dubbing_performance/language	base/schemastaging	language
/award/award_winning_work/awards_won./award/award_honor/honored_for	award	award
/business/board_member/leader_of./organization/leadership/organization	business	organization
/education/university/international_tuition./measurement_unit/dated_money_value/currency	education	finance
/fictional_universe/fictional_character/occupation	fictional_universe	fictional_universe
/base/schemastaging/athlete_extra/salary./base/schemastaging/athlete_salary/team	base/schemastaging	base/schemastaging
/organization/organization/acquired_by./business/acquisition/acquiring_company	organization	organization
/baseball/baseball_team/historical_roster./sports/sports_team_roster/player	baseball	sports
/music/group_member/membership./music/group_membership/role	music	music
/location/us_county/hud_county_place	location	location
/base/yalebase/secret_society/notable_members./base/yalebase/secret_society_membership/member	base/yalebase	base/yalebase
/base/rugby/rugby_player/type_of_rugby	base/rugby	base/rugby
/location/hud_foreclosure_area/estimated_number_of_mortgages./measurement_unit/dated_integer/source	location	dataworld
/aviation/airline/airports_served./aviation/airline_airport_presence/airport	aviation	aviation
/medicine/drug_ingredient/more_general_ingredient	medicine	medicine
/film/film/distributors./film/film_film_distributor_relationship/region	film	location
/fictional_universe/person_in_fiction/representations_in_fiction	fictional_universe	fictional_universe
/base/locations/continents/countries_within	base/locations	base/locations
/people/person/education./education/education/major_field_of_study	people	education
/award/award_winning_work/awards_won./award/award_honor/award	award	award
/music/artist/album	music	music
/cvg/computer_game_subject/games	cvg	cvg
/tv/tv_personality/tv_regular_appearances./tv/tv_regular_personal_appearance/appearance_type	tv	tv
/aviation/aircraft_owner/aircraft_fleet_composition./aviation/aircraft_ownership_count/aircraft_model	aviation	aviation
/military/military_commander/military_commands./military/military_command/military_conflict	military	military
/education/school/school_district	education	education
/fictional_universe/fictional_character/children	fictional_universe	fictional_universe
/tv/tv_series_season/regular_cast./tv/regular_tv_appearance/series	tv	tv
/computer/software/license	computer	computer
/broadcast/tv_station/owner	broadcast	broadcast
/architecture/museum/type_of_museum	architecture	architecture
/award/recurring_competition/individual_competitions	award	award
/people/profession/people_with_this_profession	people	people
/fictional_universe/fictional_character/character_created_by	fictional_universe	fictional_universe
/base/endorsements/endorsee/newspaper_endorsements./base/endorsements/newspaper_endorsement/newspaper	base/endorsements	base/endorsements
/film/writer/film	film	film
/tv/tv_producer_type/tv_producers_of_this_type./tv/tv_producer_term/program	tv	tv
/location/hud_foreclosure_area/hhuniv./measurement_unit/dated_integer/source	location	dataworld
/military/military_conflict/commanders./military/military_command/military_commander	military	military
/music/artist/genre	music	music
/food/dietary_restriction/compatible_ingredients	food	food
/tv/tv_program/regular_personal_appearances./tv/tv_regular_personal_appearance/appearance_type	tv	tv
/award/award_category/winners./award/award_honor/ceremony	award	award
/computer/computer/manufacturer	computer	computer
/government/governmental_jurisdiction/governing_officials./government/government_position_held/office_holder	government	government
/religion/religious_practice/practice_of	religion	religion
/music/genre/albums	music	music
/government/governmental_jurisdiction/official_symbols./location/location_symbol_relationship/symbol	government	location
/organization/organization/phone_number./common/phone_number/category	organization	organization
/base/activism/activism_issue/activists	base/activism	base/activism
/base/endorsements/endorsing_newspaper/endorsements./base/endorsements/newspaper_endorsement/election	base/endorsements	government
/government/political_district/representatives./government/government_position_held/office_holder	government	government
/music/performance_role/regular_performances./music/group_membership/role	music	music
/common/webpage/topic	common	common
/tennis/tennis_player/matches_lost./tennis/tennis_match/winner	tennis	tennis
/basketball/basketball_team/historical_roster./sports/sports_team_roster/player	basketball	sports
/location/location/partially_containedby	location	location
/location/statistical_region/religions./location/religion_percentage/religion	location	religion
/government/governmental_body/members./government/government_position_held/legislative_sessions	government	government
/tv/tv_series_season/series	tv	tv
/cvg/computer_videogame/cvg_genre	cvg	cvg
/government/governmental_jurisdiction/governing_officials./government/government_position_held/office_position_or_title	government	government
/transportation/road/end2./transportation/road_starting_point/location	transportation	location
/military/military_person/service./military/military_service/military_force	military	military
/american_football/football_team/historical_roster./sports/sports_team_roster/position	american_football	sports
/people/appointer/appointment_made./people/appointment/appointed_role	people	people
/government/political_district/representatives./government/government_position_held/jurisdiction_of_office	government	government
/user/coco/science/concepts_theories/child_concept	user/coco/science	user/coco/science
/fictional_universe/fictional_character/romantically_involved_with./fictional_universe/romantic_involvement/partner	fictional_universe	fictional_universe
/military/military_combatant/military_conflicts./military/military_combatant_group/combatants	military	military
/base/popstra/business_location/customer./base/popstra/hangout/customer	base/popstra	base/popstra
/base/activism/activism_issue/activist_organizations	base/activism	base/activism
/base/contractbridge/bridge_player/second_place_finish./base/contractbridge/bridge_tournament_standings/tournament	base/contractbridge	base/contractbridge
/base/patronage/client/related_patron./base/patronage/patron_client_relationship/patron	base/patronage	base/patronage
/people/ethnicity/languages_spoken	people	language
/internet/website_category/sites	internet	internet
/people/appointer/appointment_made./people/appointment/appointee	people	people
/award/award_category/presenting_organization	award	award
/biology/organism_classification/organisms_of_this_type	biology	biology
/film/actor/film./film/performance/character	film	film
/government/politician/party./government/political_party_tenure/party	government	government
/american_football/football_player/games./american_football/player_game_statistics/team	american_football	american_football
/base/schemastaging/tv_actor_extra/regular_dubbing_performances./base/schemastaging/tv_star_dubbing_performance/character	base/schemastaging	base/schemastaging
/language/human_language/region	language	location
/user/lindenb/default_domain/scientist/known_for	user/lindenb/default_domain	common
/fictional_universe/fictional_character/siblings./fictional_universe/sibling_relationship_of_fictional_characters/siblings	fictional_universe	fictional_universe
/people/person/profession	people	people
/computer/software/developer	computer	computer
/user/alexander/philosophy/philosopher/interests	user/alexander/philosophy	user/alexander/philosophy
/government/government_office_category/officeholders./government/government_position_held/office_position_or_title	government	government
/government/governmental_body/offices_positions	government	government
/american_football/football_team/historical_roster./sports/sports_team_roster/player	american_football	sports
/film/film_story_contributor/film_story_credits	film	film
/user/alexander/philosophy/era/philosophers	user/alexander/philosophy	user/alexander/philosophy
/film/producer/films_executive_produced	film	film
/visual_art/artwork/art_subject	visual_art	visual_art
/visual_art/visual_artist/art_forms	visual_art	visual_art
/american_football/football_coach_position/coaches_holding_this_position./american_football/football_historical_coach_position/coach	american_football	american_football
/location/hud_foreclosure_area/estimated_number_foreclosures./measurement_unit/dated_integer/source	location	dataworld
/film/film_format/film_format	film	film
/government/political_district/representatives./government/government_position_held/legislative_sessions	government	government
/broadcast/content/genre	broadcast	broadcast
/sports/sports_team_owner/teams_owned	sports	sports
/education/fraternity_sorority/colleges_and_universities	education	education
/time/time_zone/locations_in_this_time_zone	time	location
/film/film_featured_song/performed_by	film	music
/base/onephylogeny/type_of_thing/included_in	base/onephylogeny	base/onephylogeny
/royalty/noble_title/holders./royalty/noble_title_tenure/noble_person	royalty	royalty
/olympics/olympic_athlete/medals_won./olympics/olympic_medal_honor/medalist	olympics	olympics
/people/deceased_person/place_of_death	people	location
/award/award_nominee/award_nominations./award/award_nomination/nominated_for	award	award
/soccer/football_league/teams./soccer/football_league_participation/team	soccer	soccer
/base/popstra/celebrity/canoodled./base/popstra/canoodled/participant	base/popstra	base/popstra
/architecture/structure/owner./architecture/ownership/owner	architecture	architecture
/base/infrastructure/power_plant_type/power_station	base/infrastructure	base/infrastructure
/government/governmental_body/sessions	government	government
/music/group_member/instruments_played	music	music
/broadcast/broadcast/area_served	broadcast	location
/film/film_distributor/films_distributed./film/film_film_distributor_relationship/film	film	film
/base/schemastaging/athlete_extra/salary./base/schemastaging/athlete_salary/currency	base/schemastaging	finance
/comic_books/comic_book_creator/characters_created	comic_books	comic_books
/user/tsegaran/random/taxonomy_subject/entry./user/tsegaran/random/taxonomy_entry/taxonomy	user/tsegaran/random	user/tsegaran/random
/location/statistical_region/gdp_nominal_per_capita./measurement_unit/dated_money_value/currency	location	finance
/american_football/football_player/passing./american_football/player_passing_statistics/season	american_football	sports
/sports/sports_team/arena_stadium	sports	sports
/organization/organization/place_founded	organization	location
/base/bioventurist/science_or_technology_company/develops_treatments_for_disease	base/bioventurist	base/bioventurist
/base/popstra/company/shopping_choice./base/popstra/shopping_choice/shopper	base/popstra	base/popstra
/government/political_district/representatives./government/government_position_held/governmental_body	government	government
/sports/sports_facility/teams	sports	sports
/sports/multi_event_tournament/sports	sports	sports
/base/petbreeds/dog_breed/group	base/petbreeds	base/petbreeds
/base/eating/practicer_of_diet/diet	base/eating	base/eating
/people/person/employment_history./business/employment_tenure/company	people	business
/book/written_work/subjects	book	book
/film/film/edited_by	film	film
/medicine/condition_prevention_factors/conditions_this_may_prevent	medicine	medicine
/architecture/structure/construction_cost./measurement_unit/money_value/currency	architecture	finance
/architecture/architect/architectural_style	architecture	architecture
/base/popstra/celebrity/bought./base/popstra/product_choice/product	base/popstra	base/popstra
/education/educational_institution/school_type	education	education
/base/endorsements/endorsing_newspaper/endorsements./base/endorsements/newspaper_endorsement/endorsee	base/endorsements	base/endorsements
/travel/transport_operator/travel_destinations_served./travel/transportation/transport_operator	travel	travel
/government/legislative_session/members./government/government_position_held/legislative_sessions	government	government
/location/hud_county_place/place	location	location
/award/award_category/nominees./award/award_nomination/award_nominee	award	award
/film/film/film_set_decoration_by	film	film
/education/academic/research_areas	education	education
/user/ktrueman/default_domain/international_organization/member_states	user/ktrueman/default_domain	location
/olympics/olympic_participating_country/medals_won./olympics/olympic_medal_honor/medalist	olympics	olympics
/sports/sport/pro_athletes./sports/pro_sports_played/athlete	sports	sports
/soccer/football_team_manager/team./soccer/football_team_management_tenure/team	soccer	soccer
/tv/tv_program/recurring_writers./tv/tv_program_writer_relationship/writer	tv	tv
/religion/religious_organization/associated_with	religion	religion
/film/film_character/portrayed_in_films_dubbed./film/dubbing_performance/film	film	film
/travel/travel_destination/how_to_get_here./travel/transportation/mode_of_transportation	travel	travel
/olympics/olympic_games/medals_awarded./olympics/olympic_medal_honor/country	olympics	olympics
/business/sponsored_recipient/sponsorship./business/sponsorship/sponsored_by	business	business
/organization/endowed_organization/endowment./measurement_unit/dated_money_value/currency	organization	finance
/book/written_work/author	book	book
/base/schemastaging/person_extra/net_worth./measurement_unit/dated_money_value/source	base/schemastaging	dataworld
/aviation/airline/hubs	aviation	aviation
/exhibitions/exhibition_venue/exhibitions_at_this_venue./exhibitions/exhibition_run/sponsor	exhibitions	exhibitions
/location/statistical_region/places_imported_from./location/imports_and_exports/imported_from	location	location
/aviation/airport/serves	aviation	location
/celebrities/sexual_orientation/celebrities./celebrities/sexual_orientation_phase/celebrity	celebrities	celebrities
/soccer/football_team/manager./soccer/football_team_management_tenure/manager	soccer	soccer
/sports/sports_award_winner/awards./sports/sports_award/team	sports	sports
/media_common/netflix_genre/titles	media_common	media_common
/base/schemastaging/tv_actor_extra/regular_dubbing_performances./base/schemastaging/tv_star_dubbing_performance/program	base/schemastaging	base/schemastaging
/military/military_conflict/force_strengths./military/force_strength/combatant	military	military
/religion/religion/texts	religion	religion
/people/person/children	people	people
/base/activism/activist/area_of_activism	base/activism	base/activism
/royalty/monarch/royal_line	royalty	royalty
/tv/tv_series_episode/series	tv	tv
/broadcast/genre/content	broadcast	broadcast
/organization/organization/product_of_merger./organization/organization_merger/organizations_merging	organization	organization
/theater/play/genre	theater	theater
/american_football/football_coach/coaching_history./american_football/football_historical_coach_position/position	american_football	american_football
/computer/software_developer/software	computer	computer
/sports/sports_position/players./sports/sports_team_roster/team	sports	sports
/education/school_mascot/school	education	education
/royalty/royal_line/kingdom_s_ruled	royalty	royalty
/business/business_operation/revenue./measurement_unit/dated_money_value/currency	business	finance
/base/thoroughbredracing/thoroughbred_racehorse/color	base/thoroughbredracing	base/thoroughbredracing
/sports/sports_league_season/awards./sports/sports_award/award_winner	sports	sports
/architecture/architectural_style/architects	architecture	architecture
/computer/operating_system/developer	computer	computer
/government/legislative_session/members./government/government_position_held/office_position_or_title	government	government
/cvg/computer_videogame/sequel	cvg	cvg
/olympics/olympic_games/medals_awarded./olympics/olympic_medal_honor/medalist	olympics	olympics
/base/wrestling/professional_wrestler/member_of_team	base/wrestling	base/wrestling
/finance/currency/countries_formerly_used	finance	location
/base/schemastaging/tv_character_extra/regular_dubbing_performances./base/schemastaging/tv_star_dubbing_performance/actor	base/schemastaging	base/schemastaging
/geography/geographical_feature/category	geography	geography
/award/award_presenting_organization/award_categories_presented	award	award
/computer/operating_system/includes_os_versions	computer	computer
/sports/sport/related_equipment	sports	sports
/tv/tv_producer/tv_episodes_produced./tv/tv_producer_episode_credit/episode	tv	tv
/people/person/spouse_s./people/marriage/type_of_union	people	people
/food/dish/ingredients	food	food
/film/film/film_production_design_by	film	film
/military/military_post/used_by_armed_forces./military/military_post_use/armed_force	military	military
/user/tsegaran/computer/algorithm_family/algorithm	user/tsegaran/computer	user/tsegaran/computer
/base/popstra/celebrity/supporter./base/popstra/support/supported_organization	base/popstra	base/popstra
/sports/sports_league_season/awards./sports/sports_award/award	sports	sports
/language/language_writing_system/languages	language	language
/base/schemastaging/organization_extra/phone_number./base/schemastaging/phone_sandbox/contact_category	base/schemastaging	organization
/film/film_festival_event/festival	film	film
/cvg/cvg_designer/games_designed	cvg	cvg
/government/governmental_jurisdiction/government_bodies	government	government
/base/folklore/mythical_creature/mythology	base/folklore	base/folklore
/tv/non_character_role/tv_guest_personal_appearances./tv/tv_guest_personal_appearance/person	tv	tv
/location/location/events	location	time
/education/educational_institution/colors	education	visual_art
/law/inventor/inventions	law	law
/base/schemastaging/tv_program_extra/regular_dubbing_performances./base/schemastaging/tv_star_dubbing_performance/actor	base/schemastaging	base/schemastaging
/film/film_festival/location	film	location
/theater/play/lyricist	theater	theater
/people/person/education./education/education/degree	people	education
/astronomy/star_system_body/star_system	astronomy	astronomy
/base/x2010fifaworldcupsouthafrica/world_cup_squad/current_world_cup_squad./base/x2010fifaworldcupsouthafrica/current_world_cup_squad/players	base/x2010fifaworldcupsouthafrica	base/x2010fifaworldcupsouthafrica
/base/fight/sentence/convictions./base/crime/criminal_conviction/convicted_person	base/fight	base/crime
/base/americancomedy/comedy_group/members./base/americancomedy/comedy_group_membership/member	base/americancomedy	base/americancomedy
/protected_sites/governing_body_of_protected_sites/protected_sites_governed	protected_sites	protected_sites
/business/job_title/people_with_this_title./business/employment_tenure/company	business	business
/tv/tv_series_episode/writer	tv	tv
/government/legislative_session/members./government/government_position_held/jurisdiction_of_office	government	government
/business/job_title/people_with_this_title./business/employment_tenure/person	business	people
/base/localfood/produce/availability./base/localfood/produce_availability/seasonal_months	base/localfood	base/localfood
/film/film_character/portrayed_in_films./film/performance/film	film	film
/base/schemastaging/tv_character_extra/regular_dubbing_performances./base/schemastaging/tv_star_dubbing_performance/language	base/schemastaging	language
/sports/sports_award_type/winners./sports/sports_award/award_winner	sports	sports
/broadcast/radio_station/format	broadcast	broadcast
/common/topic/webpage./common/webpage/category	common	common
/sports/sport/teams	sports	sports
/sports/sports_team_location/teams	sports	sports
/basketball/basketball_position/player_roster_position./sports/sports_team_roster/team	basketball	sports
/people/person/languages	people	language
/base/popstra/company/product_endorser./base/popstra/paid_support/endorser	base/popstra	base/popstra
/basketball/basketball_team/roster./sports/sports_team_roster/player	basketball	sports
/broadcast/content/location	broadcast	location
/book/written_work/original_language	book	language
/time/event/instance_of_recurring_event	time	time
/sports/sports_team/roster./sports/sports_team_roster/player	sports	sports
/music/instrument/variation	music	music
/sports/drafted_athlete/drafted./sports/sports_league_draft_pick/team	sports	sports
/film/film_costumer_designer/costume_design_for_film	film	film
/ice_hockey/hockey_player/hockey_position	ice_hockey	ice_hockey
/olympics/olympic_athlete/country./olympics/olympic_athlete_affiliation/sport	olympics	olympics
/geography/river/cities	geography	location
/military/armed_force/military_posts./military/military_post_use/military_post	military	military
/film/film/film_series	film	film
/medicine/medical_specialty/diseases_treated	medicine	medicine
/film/film_job/films_with_this_crew_job./film/film_crew_gig/film	film	film
/base/contractbridge/bridge_player/first_place_finish./base/contractbridge/bridge_tournament_standings/first_place	base/contractbridge	base/contractbridge
/sports/sports_official/sport	sports	sports
/film/film/country	film	location
/american_football/football_team/current_roster./sports/sports_team_roster/position	american_football	sports
/book/periodical_subject/periodicals	book	book
/film/film/starring./film/performance/actor	film	film
/award/hall_of_fame/discipline	award	award
/government/government_office_or_title/office_holders./government/government_position_held/office_holder	government	government
/computer/computer_manufacturer_brand/computer_models	computer	computer
/government/governmental_jurisdiction/agencies	government	government
/travel/transport_terminus/travel_destinations_served./travel/transportation/travel_destination	travel	travel
/common/resource/annotations./common/webpage/topic	common	common
/base/crime/crime/victim_s	base/crime	base/crime
/base/bioventurist/bv_medical_condition/company_involved	base/bioventurist	base/bioventurist
/base/marchmadness/ncaa_basketball_team/ncaa_tournament_seeds./base/marchmadness/ncaa_tournament_seed/tournament	base/marchmadness	base/marchmadness
/common/topic/webpage./common/webpage/resource	common	common
/music/album/genre	music	music
/sports/sports_championship/events	sports	sports
/tv/tv_program/languages	tv	language
/dataworld/gardening_hint/split_to	dataworld	type
/internet/website/owner_new./internet/website_ownership/owner	internet	internet
/religion/religion/includes	religion	religion
/government/legislative_session/legislature	government	government
/transportation/bridge_type/bridges_of_this_type	transportation	transportation
/american_football/football_team/historical_coaching_staff./american_football/football_historical_coach_position/coach	american_football	american_football
/baseball/baseball_player/lifetime_batting_statistics./baseball/lifetime_batting_statistics/last_statistics_season	baseball	sports
/tv/tv_program/regular_personal_appearances./tv/tv_regular_personal_appearance/person	tv	tv
/music/musical_group/member./music/group_membership/member	music	music
/tv/tv_program/filming_locations	tv	tv
/user/mt/default_domain/metabolite/associated_disorder	user/mt/default_domain	medicine
/award/long_list_nominee/long_list_nominations./award/long_list_nomination/award	award	award
/medicine/disease/symptoms	medicine	medicine
/language/human_language/main_country	language	location
/tv/tv_network/programs./tv/tv_network_duration/program	tv	tv
/base/crime/convicted_criminal/convictions./base/crime/criminal_conviction/sentence_type	base/crime	base/fight
/fictional_universe/work_of_fiction/setting	fictional_universe	fictional_universe
/computer/operating_system/parent_os	computer	computer
/fictional_universe/fictional_character/based_on	fictional_universe	fictional_universe
/olympics/olympic_games/participating_countries	olympics	olympics
/book/magazine/genre	book	book
/base/popstra/location/vacationers./base/popstra/vacation_choice/vacationer	base/popstra	base/popstra
/military/military_combatant/military_commanders./military/military_command/military_commander	military	military
/government/politician/government_positions_held./government/government_position_held/office_position_or_title	government	government
/medicine/disease/notable_people_with_this_condition	medicine	medicine
/education/educational_degree/people_with_this_degree./education/education/major_field_of_study	education	education
/sports/pro_athlete/teams./sports/sports_team_roster/team	sports	sports
/base/collectives/collective_member/member_of./base/collectives/collective_membership/collective	base/collectives	base/collectives
/aviation/airport/airlines./aviation/airline_airport_presence/airline	aviation	aviation
/soccer/football_player/matches_played./soccer/football_player_match_participation/team	soccer	soccer
/film/actor/dubbing_performances./film/dubbing_performance/film	film	film
/tv/tv_program/country_of_origin	tv	location
/education/field_of_study/students_majoring./education/education/student	education	people
/film/actor/film./film/performance/special_performance_type	film	film
/location/administrative_division/capital./location/administrative_division_capital_relationship/capital	location	location
/biology/breed_registry/recognized_breeds./biology/breed_registration/breed	biology	biology
/music/record_label/artist	music	music
/media_common/adapted_work/adaptations	media_common	media_common
/user/tfmorris/default_domain/document/signatories	user/tfmorris/default_domain	user/tfmorris/default_domain
/comic_books/comic_book_publisher/comic_book_series_published	comic_books	comic_books
/medicine/disease_cause/diseases	medicine	medicine
/government/governmental_body/jurisdiction	government	government
/user/tsegaran/computer/algorithm/family	user/tsegaran/computer	user/tsegaran/computer
/film/film/dubbing_performances./film/dubbing_performance/character	film	film
/education/field_of_study/students_majoring./education/education/institution	education	education
/government/political_appointer/appointees./government/government_position_held/basic_title	government	government
/religion/religious_organization/leaders./religion/religious_organization_leadership/leader	religion	religion
/base/popstra/product/sold_to./base/popstra/product_choice/consumer	base/popstra	base/popstra
/military/military_commander/military_commands./military/military_command/military_combatant	military	military
/fictional_universe/ethnicity_in_fiction/characters_of_this_ethnicity	fictional_universe	fictional_universe
/food/ingredient/incompatible_with_dietary_restrictions	food	food
/government/governmental_body/component_bodies	government	government
/protected_sites/listed_site/designation_as_natural_or_cultural_site./protected_sites/natural_or_cultural_site_listing/category_or_criteria	protected_sites	protected_sites
/metropolitan_transit/transit_system/area_served	metropolitan_transit	location
/architecture/structure/architect	architecture	architecture
/organization/membership_organization/members./organization/organization_membership/member	organization	organization
/metropolitan_transit/transit_service_type/transit_lines	metropolitan_transit	metropolitan_transit
/computer/operating_system_developer/operating_systems_developed	computer	computer
/theater/theatrical_lyricist/play_lyrics_written	theater	theater
/education/educational_degree/people_with_this_degree./education/education/specialization	education	education
/location/hud_foreclosure_area/total_residential_addresses./measurement_unit/dated_integer/source	location	dataworld
/education/fraternity_sorority/colors	education	visual_art
/base/fashionmodels/hair_color/fashion_models_with_this_hair_color	base/fashionmodels	base/fashionmodels
/language/human_language/language_family	language	language
/protected_sites/protected_site/iucn_category	protected_sites	protected_sites
/organization/organization/headquarters./location/mailing_address/state_province_region	organization	location
/film/film_casting_director/films_casting_directed	film	film
/government/governmental_body/members./government/government_position_held/basic_title	government	government
/astronomy/celestial_object_category/objects	astronomy	astronomy
/organization/organization/child./organization/organization_relationship/child	organization	organization
/american_football/football_player/rushing./american_football/player_rushing_statistics/team	american_football	american_football
/film/film/genre	film	film
/olympics/olympic_participating_country/athletes./olympics/olympic_athlete_affiliation/olympics	olympics	olympics
/comic_books/comic_book_creator/series_created	comic_books	comic_books
/business/consumer_company/brands./business/company_brand_relationship/brand	business	business
/biology/breed_origin/breeds_originating_here	biology	biology
/aviation/airport/airlines./aviation/airline_airport_presence/cities_served	aviation	location
/law/invention/inventor	law	law
/broadcast/content/broadcast	broadcast	broadcast
/award/award_category/winners./award/award_honor/award_winner	award	award
/medicine/notable_person_with_medical_condition/condition	medicine	medicine
/biology/organism_classification/lower_classifications	biology	biology
/media_common/netflix_title/netflix_genres	media_common	media_common
/law/court/judges./law/judicial_tenure/judge	law	law
/olympics/olympic_games/sports	olympics	olympics
/base/petbreeds/dog_breed/cities_where_this_dog_is_popular./base/petbreeds/dog_city_relationship/cities	base/petbreeds	base/petbreeds
/organization/organization_founder/organizations_founded	organization	organization
/film/film_festival_event/films	film	film
/celebrities/celebrity/sexual_orientation./celebrities/sexual_orientation_phase/sexual_orientation	celebrities	celebrities
/base/culturalevent/event/entity_involved	base/culturalevent	common
/sports/sports_team/league./sports/sports_league_participation/league	sports	sports
/broadcast/broadcast/distributor	broadcast	broadcast
/music/performance_role/guest_performances./music/recording_contribution/performance_role	music	music
/sports/sports_championship_event/champion	sports	sports
/tv/tv_program/tv_producer./tv/tv_producer_term/producer_type	tv	tv
/tennis/tennis_tournament_champion/tennis_titles./tennis/tennis_tournament_championship/winner	tennis	tennis
/film/film/costume_design_by	film	film
/computer/programming_language_paradigm/languages	computer	computer
/user/tsegaran/random/subject_taxonomy/entry./user/tsegaran/random/taxonomy_entry/subject	user/tsegaran/random	user/tsegaran/random
/organization/organization/spin_offs./organization/organization_spin_off/child_company	organization	organization
/book/periodical/publisher./book/periodical_publisher_period/publisher	book	book
/award/award_winner/awards_won./award/award_honor/award	award	award
/award/hall_of_fame_inductee/hall_of_fame_inductions./award/hall_of_fame_induction/hall_of_fame	award	award
/cvg/game_character/games./cvg/game_performance/voice_actor	cvg	cvg
/base/eating/diets/people_who_follow_this_diet	base/eating	base/eating
/soccer/football_team/current_roster./sports/sports_team_roster/player	soccer	sports
/sports/sports_league_draft/picks./sports/sports_league_draft_pick/player	sports	sports
/soccer/football_team/league./soccer/football_league_participation/league	soccer	soccer
/olympics/olympic_athlete/country./olympics/olympic_athlete_affiliation/country	olympics	olympics
/baseball/baseball_player/batting_stats./baseball/batting_statistics/team	baseball	baseball
/organization/organization/sectors	organization	organization
/sports/sports_team/roster./sports/sports_team_roster/position	sports	sports
/sports/sports_award_type/winners./sports/sports_award/season	sports	sports
/education/field_of_study/students_majoring./education/education/degree	education	education
/base/schemastaging/organization_extra/phone_number./base/schemastaging/phone_open_times/time_zone	base/schemastaging	time
/people/person/ethnicity	people	people
/film/film_series/films_in_series	film	film
/astronomy/orbital_relationship/orbited_by	astronomy	astronomy
/government/legislative_session/members./government/government_position_held/governmental_body	government	government
/education/field_of_study/subdisciplines	education	education
/biology/organism/organism_type	biology	biology
/government/government_office_category/officeholders./government/government_position_held/jurisdiction_of_office	government	government
/award/hall_of_fame_discipline/halls_of_fame	award	award
/olympics/olympic_games/athletes./olympics/olympic_athlete_affiliation/athlete	olympics	olympics
/business/business_operation/current_liabilities./measurement_unit/dated_money_value/currency	business	finance
/film/film/estimated_budget./measurement_unit/dated_money_value/currency	film	finance
/business/sponsor/sponsorship./business/sponsorship/sponsored_recipient	business	business
/media_common/media_genre/parent_genre	media_common	media_common
/olympics/olympic_sport/athletes./olympics/olympic_athlete_affiliation/athlete	olympics	olympics
/medicine/icd_9_cm_classification/includes_classifications	medicine	medicine
/american_football/football_player/passing./american_football/player_passing_statistics/team	american_football	american_football
/government/government_office_category/officeholders./government/government_position_held/office_holder	government	government
/location/country/capital	location	location
/location/location/adjoin_s./location/adjoining_relationship/adjoins	location	location
/medicine/infectious_disease/infectious_agent_type	medicine	medicine
/user/alexbl/honorary_title/honorary_title/titled_people./user/alexbl/honorary_title/honorary_title_holding/conferred_upon	user/alexbl/honorary_title	user/alexbl/honorary_title
/common/topic/subject_of	common	common
/american_football/football_player/position_s	american_football	sports
/government/government_office_category/officeholders./government/government_position_held/appointed_by	government	government
/royalty/kingdom/rulers	royalty	royalty
/biology/organism/sex	biology	people
/broadcast/distributor/distributes	broadcast	broadcast
/government/government_office_or_title/office_holders./government/government_position_held/governmental_body	government	government
/media_common/dedicatee/dedications./media_common/dedication/work_dedicated	media_common	media_common
/base/localfood/seasonal_month/produce_available./base/localfood/produce_availability/produce	base/localfood	base/localfood
/film/film/produced_by	film	film
/book/author/school_or_movement	book	book
/music/artist/origin	music	location
/sports/professional_sports_team/draft_picks./sports/sports_league_draft_pick/school	sports	education
/tv/tv_character/appeared_in_tv_program./tv/regular_tv_appearance/actor	tv	tv
/sports/sports_team/championships	sports	sports
/common/topic/subjects	common	common
/government/government_office_category/officeholders./government/government_position_held/governmental_body	government	government
/government/political_appointer/appointees./government/government_position_held/jurisdiction_of_office	government	government
/organization/role/governors./organization/organization_board_membership/member	organization	business
/people/marriage_union_type/unions_of_this_type./people/marriage/location_of_ceremony	people	location
/tv/special_tv_performance_type/starring_performances./tv/regular_tv_appearance/series	tv	tv
/film/film/language	film	language
/medicine/symptom/symptom_of	medicine	medicine
/location/location/street_address./location/mailing_address/citytown	location	location
/ice_hockey/hockey_team/historical_roster./sports/sports_team_roster/player	ice_hockey	sports
/fictional_universe/character_occupation/characters_with_this_occupation	fictional_universe	fictional_universe
/travel/transport_operator/travel_destinations_served./travel/transportation/mode_of_transportation	travel	travel
/fictional_universe/work_of_fiction/part_of_these_fictional_universes	fictional_universe	fictional_universe
/government/government_office_category/offices	government	government
/base/schemastaging/person_extra/net_worth./measurement_unit/dated_money_value/currency	base/schemastaging	finance
/base/marchmadness/ncaa_basketball_tournament/seeds./base/marchmadness/ncaa_tournament_seed/team	base/marchmadness	base/marchmadness
/location/administrative_division/second_level_division_of	location	location
/fictional_universe/fictional_setting/works_set_here	fictional_universe	fictional_universe
/tv/tv_personality/tv_regular_appearances./tv/tv_regular_personal_appearance/program	tv	tv
/tv/tv_actor/guest_roles./tv/tv_guest_role/episodes_appeared_in	tv	tv
/visual_art/artwork/art_genre	visual_art	visual_art
/location/statistical_region/places_exported_to./location/imports_and_exports/exported_to	location	location
/film/film/film_festivals	film	film
/computer/programming_language/parent_language	computer	computer
/computer/computer/compatible_oses./computer/os_compatibility/operating_system	computer	computer
/fictional_universe/fictional_character/powers_or_abilities	fictional_universe	fictional_universe
/award/award/category	award	award
/sports/sports_championship_event/runner_up	sports	sports
/location/statistical_region/gdp_nominal./measurement_unit/dated_money_value/currency	location	finance
/travel/travel_destination/tourist_attractions	travel	travel
/travel/transport_terminus/travel_destinations_served./travel/transportation/mode_of_transportation	travel	travel
/film/film_character/portrayed_in_films./film/performance/actor	film	film
/education/academic/appointments_fellowships_etc./education/academic_post/institution	education	education
/location/us_county/county_seat	location	location
/government/government_office_or_title/office_holders./government/government_position_held/legislative_sessions	government	government
/government/government_office_or_title/jurisdiction	government	government
/award/award_ceremony/awards_presented./award/award_honor/honored_for	award	award
/award/award_nominated_work/award_nominations./award/award_nomination/nominated_for	award	award
/film/film/runtime./film/film_cut/film_release_region	film	location
/film/director/film	film	film
/basketball/basketball_position/players	basketball	basketball
/base/popstra/celebrity/dated./base/popstra/dated/participant	base/popstra	base/popstra
/soccer/football_player/position_s	soccer	soccer
/tv/tv_character/appeared_in_tv_program./tv/regular_tv_appearance/series	tv	tv
/location/hud_foreclosure_area/total_90_day_vacant_residential_addresses./measurement_unit/dated_integer/source	location	dataworld
/user/szaijan/fantasy_football/player/position	user/szaijan/fantasy_football	user/szaijan/fantasy_football
/government/form_of_government/countries	government	location
/business/board_member/organization_board_memberships./organization/organization_board_membership/role	business	organization
/tv/tv_program/episodes	tv	tv
/location/administrative_division/first_level_division_of	location	location
/organization/organization/organization_type	organization	organization
/base/x2010fifaworldcupsouthafrica/world_cup_squad/current_world_cup_squad./base/x2010fifaworldcupsouthafrica/current_world_cup_squad/current_club	base/x2010fifaworldcupsouthafrica	soccer
/aviation/airport/focus_city_for	aviation	aviation
/government/government_office_or_title/office_holders./government/government_position_held/jurisdiction_of_office	government	government
/base/academyawards/host_of_oscar_show/oscar_show_hosted	base/academyawards	time
/base/popstra/celebrity/endorsements./base/popstra/paid_support/company	base/popstra	base/popstra
/business/business_operation/net_profit./measurement_unit/dated_money_value/currency	business	finance
/film/film/film_format	film	film
/government/governmental_jurisdiction/governing_officials./government/government_position_held/governmental_body	government	government
/film/film/featured_film_locations	film	film
/geography/geographical_feature_category/features	geography	geography
/book/book/genre	book	media_common
/government/governmental_body/members./government/government_position_held/jurisdiction_of_office	government	government
/organization/organization_scope/organizations_with_this_scope	organization	organization
/book/periodical_format/periodicals_in_this_format./book/periodical_format_period/periodical	book	book
/computer/software/compatible_oses./computer/software_compatibility/operating_system	computer	computer
/base/argumentmaps/innovator/original_ideas	base/argumentmaps	base/argumentmaps
/travel/travel_destination/climate./travel/travel_destination_monthly_climate/month	travel	time
/venture_capital/venture_investor/investments./venture_capital/venture_investment/company	venture_capital	venture_capital
/tv/tv_series_season/regular_cast./tv/regular_tv_appearance/actor	tv	tv
/music/genre/subgenre	music	music
/tv/tv_producer/programs_produced./tv/tv_producer_term/producer_type	tv	tv
/architecture/architectural_structure_owner/structures_owned./architecture/ownership/structure	architecture	architecture
/organization/organization/legal_structure	organization	business
/influence/influence_node/influenced_by	influence	influence
/time/event/included_in_event	time	time
/sports/drafted_athlete/drafted./sports/sports_league_draft_pick/draft	sports	sports
/location/hud_county_place/county	location	location
/cvg/computer_videogame/gameplay_modes	cvg	cvg
/award/award_category/winners./award/award_honor/honored_for	award	award
/dining/cuisine/ingredients	dining	food
/government/governmental_jurisdiction/governing_officials./government/government_position_held/district_represented	government	government
/award/hall_of_fame_inductee/hall_of_fame_inductions./award/hall_of_fame_induction/category	award	award
/computer/programming_language/influenced	computer	computer
/tv/tv_character/appeared_in_tv_episodes./tv/tv_guest_role/actor	tv	tv
/education/school_district/locations_served	education	location
/exhibitions/exhibition_sponsor/exhibitions_sponsored./exhibitions/exhibition_run/sponsor	exhibitions	exhibitions
/people/family/members	people	people
/broadcast/content/artist	broadcast	broadcast
/organization/organization/leadership./organization/leadership/person	organization	business
/music/concert_tour/artist	music	music
/transportation/road/major_cities	transportation	location
/base/petbreeds/city_with_dogs/top_breeds./base/petbreeds/dog_city_relationship/dog_breed	base/petbreeds	base/petbreeds
/ice_hockey/hockey_team/current_roster./sports/sports_team_roster/player	ice_hockey	sports
/government/political_ideology/political_parties	government	government
/user/robert/us_congress/congressional_caucus/current_house_members	user/robert/us_congress	user/robert/us_congress
/government/governmental_jurisdiction/governing_officials./government/government_position_held/legislative_sessions	government	government
/government/government_office_category/officeholders./government/government_position_held/district_represented	government	government
/exhibitions/exhibition_sponsor/exhibitions_sponsored./exhibitions/exhibition_run/venue	exhibitions	exhibitions
/media_common/adaptation/adapted_from	media_common	media_common
/base/crime/convicted_criminal/convictions./base/crime/criminal_conviction/guilty_of	base/crime	base/fight
/education/educational_institution/subsidiary_or_constituent_schools	education	education
/biology/domesticated_animal/breeds	biology	biology
/people/deceased_person/place_of_cremation	people	location
/film/film/sequel	film	film
/religion/religious_leader/religious_leadership./religion/religious_organization_leadership/organization	religion	religion
/organization/organization/headquarters./location/mailing_address/citytown	organization	location
/film/personal_film_appearance_type/film_appearances./film/personal_film_appearance/person	film	film
/fictional_universe/fictional_job_title/fictional_characters_with_this_job./fictional_universe/fictional_employment_tenure/employee	fictional_universe	fictional_universe
/location/country/currency_formerly_used	location	finance
/education/academic/advisors	education	education
/government/political_party/ideology	government	government
/organization/organization/founders	organization	organization
/people/person/places_lived./people/place_lived/location	people	location
/sports/sports_equipment/sport_used_for	sports	sports
/user/robert/military/military_person/participated_in_conflicts	user/robert/military	military
/comic_books/comic_book_fictional_universe/characters_primarily_appearing_in_this_universe	comic_books	comic_books
/music/instrument/family	music	music
/education/educational_institution/students_graduates./education/education/student	education	people
/base/x2010fifaworldcupsouthafrica/world_cup_participant/world_cup_team./base/x2010fifaworldcupsouthafrica/current_world_cup_squad/current_club	base/x2010fifaworldcupsouthafrica	soccer
/american_football/football_player/rushing./american_football/player_rushing_statistics/season	american_football	sports
/comic_books/comic_book_character/primary_universe	comic_books	comic_books
/base/biblioness/bibs_location/city	base/biblioness	location
/film/film_crewmember/films_crewed./film/film_crew_gig/film_crew_role	film	film
/government/political_appointer/appointees./government/government_position_held/governmental_body	government	government
/cvg/cvg_developer/games_developed	cvg	cvg
/tv/tv_series_episode/guest_personal_appearances./tv/tv_guest_personal_appearance/person	tv	tv
/sports/sports_award_winner/awards./sports/sports_award/season	sports	sports
/broadcast/content/producer	broadcast	broadcast
/award/hall_of_fame_induction_category/inductees./award/hall_of_fame_induction/inductee	award	award
/fictional_universe/fictional_character/rank	fictional_universe	fictional_universe
/sports/sports_team/season_record./sports/sports_team_season_record/season	sports	sports
/language/human_language/dialects	language	language
/interests/collection_category/sub_categories	interests	interests
/tv/tv_actor/starring_roles./tv/regular_tv_appearance/special_performance_type	tv	tv
/government/political_appointer/appointees./government/government_position_held/office_position_or_title	government	government
/base/schemastaging/organization_extra/phone_number./base/schemastaging/phone_sandbox/product_or_service	base/schemastaging	base/schemastaging
/visual_art/visual_art_form/artworks	visual_art	visual_art
/common/annotation_category/annotations	common	common
/olympics/olympic_participating_country/medals_won./olympics/olympic_medal_honor/olympics	olympics	olympics
/film/film/cinematography	film	film
/language/human_language/writing_system	language	language
/base/fight/crime_type/victims_of_this_crime_type	base/fight	base/crime
/people/appointee/position./people/appointment/appointed_by	people	people
/cvg/computer_videogame/characters./cvg/game_performance/character	cvg	cvg
/fictional_universe/character_species/characters_of_this_species	fictional_universe	fictional_universe
/medicine/drug_ingredient/active_moiety_of_drug	medicine	medicine
/medicine/symptom/side_effect_of	medicine	medicine
/film/film/other_crew./film/film_crew_gig/film_crew_role	film	film
/government/governmental_jurisdiction/governing_officials./government/government_position_held/appointed_by	government	government
/olympics/olympic_medal/medal_winners./olympics/olympic_medal_honor/olympics	olympics	olympics
/base/petbreeds/dog_breed/size./base/petbreeds/dog_size/gender	base/petbreeds	base/petbreeds
/location/country/currency_used	location	finance
/user/alexander/philosophy/subject/philosophers	user/alexander/philosophy	user/alexander/philosophy
/aviation/airline_alliance/member_airlines	aviation	aviation
/military/military_conflict/military_personnel_involved	military	military
/film/film/release_date_s./film/film_regional_release_date/film_release_region	film	location
/religion/religion/practices	religion	religion
/media_common/dedicator/dedications./media_common/dedication/work_dedicated	media_common	media_common
/tv/tv_program_guest/appeared_on./tv/tv_guest_personal_appearance/appearance_type	tv	tv
/comic_books/comic_book_character/created_by	comic_books	comic_books
/computer/software/languages_used	computer	computer
/base/thoroughbredracing/thoroughbred_racehorse/sex	base/thoroughbredracing	base/thoroughbredracing
/award/ranked_list/ranked_list_items./award/ranking/item	award	award
/sports/professional_sports_team/draft_picks./sports/sports_league_draft_pick/draft	sports	sports
/olympics/olympic_games/medals_awarded./olympics/olympic_medal_honor/medal	olympics	olympics
/base/localfood/produce/availability./base/localfood/produce_availability/location	base/localfood	base/localfood
/award/competition/instance_of_recurring_competition	award	award
/sports/sports_position/players./sports/sports_team_roster/player	sports	sports
/geography/island/island_group	geography	geography
/film/film_character/portrayed_in_films_dubbed./film/dubbing_performance/actor	film	film
/award/award_category/nominees./award/award_nomination/nominated_for	award	award
/cvg/cvg_genre/games	cvg	cvg
/military/military_person/service./military/military_service/rank	military	military
/medicine/drug_ingredient/more_specific_ingredient	medicine	medicine
/baseball/baseball_league/teams	baseball	baseball
/organization/organization_type/organizations_of_this_type	organization	organization
/aviation/aircraft_manufacturer/aircraft_models_made	aviation	aviation
/film/film/starring./film/performance/character	film	film
/people/family/country	people	location
/visual_art/artwork/art_form	visual_art	visual_art
/award/award_nominee/award_nominations./award/award_nomination/award_nominee	award	award
/location/administrative_division/country	location	location
/music/performance_role/guest_performances./music/recording_contribution/contributor	music	music
/government/government_office_or_title/office_holders./government/government_position_held/basic_title	government	government
/people/appointed_role/appointment./people/appointment/appointee	people	people
/geography/lake/basin_countries	geography	location
/government/governmental_jurisdiction/governing_officials./government/government_position_held/basic_title	government	government
/travel/tourist_attraction/near_travel_destination	travel	travel
/book/author/works_written	book	book
/broadcast/content/language	broadcast	language
/food/ingredient/compatible_with_dietary_restrictions	food	food
/basketball/basketball_position/player_roster_position./sports/sports_team_roster/player	basketball	sports
/american_football/football_team/historical_coaching_staff./american_football/football_historical_coach_position/position	american_football	american_football
/base/nobelprizes/nobel_subject_area/nobel_awards./base/nobelprizes/nobel_honor/subject_area	base/nobelprizes	base/nobelprizes
/film/film/distributors./film/film_film_distributor_relationship/film_distribution_medium	film	film
/people/person/gender	people	people
/award/hall_of_fame/inductees./award/hall_of_fame_induction/inductee	award	award
/religion/religion/deities	religion	religion
/language/language_dialect/language	language	language
/award/award_nominee/award_nominations./award/award_nomination/award	award	award
/people/deceased_person/cause_of_death	people	people
/tv/tv_program_creator/programs_created	tv	tv
/education/educational_institution/students_graduates./education/education/minor	education	education
/location/location/people_born_here	location	people
/biology/breed_group/breeds_in_this_group./biology/breed_registration/breed	biology	biology
/tv/non_character_role/tv_regular_personal_appearances./tv/tv_regular_personal_appearance/person	tv	tv
/film/film_job/films_with_this_crew_job./film/film_crew_gig/crewmember	film	film
/internet/website/category	internet	internet
/book/newspaper/headquarters./location/mailing_address/state_province_region	book	location
/location/location/nearby_airports	location	aviation
/sports/sports_league_draft/picks./sports/sports_league_draft_pick/school	sports	education
/government/government_agency/jurisdiction	government	government
/tv/tv_program/regular_cast./tv/regular_tv_appearance/special_performance_type	tv	tv
/base/popstra/celebrity/religion./base/popstra/religion_choice/religion	base/popstra	base/popstra
/government/government_office_category/officeholders./government/government_position_held/legislative_sessions	government	government
/food/ingredient/dishes	food	food
/geography/river/mouth	geography	location
/location/location/contains	location	location
/book/periodical_publisher/periodicals_published./book/periodical_publisher_period/periodical	book	book
/film/film_location/featured_in_films	film	film
/base/collectives/collective/members./base/collectives/collective_membership/member	base/collectives	base/collectives
/medicine/disease/parent_disease	medicine	medicine
/film/film/other_crew./film/film_crew_gig/crewmember	film	film
/film/film_festival/individual_festivals	film	film
/medicine/disease/medical_specialties	medicine	medicine
/chemistry/chemical_compound/solubility./chemistry/solubility_relationship/solvent	chemistry	chemistry
/organization/organization/involved_in_merger./organization/organization_merger/organizations_merging	organization	organization
/business/board_member/organization_board_memberships./organization/organization_board_membership/organization	business	organization
/tv/tv_program/tv_producer./tv/tv_producer_term/producer	tv	tv
/base/petbreeds/dog_breed_group/dog_breeds	base/petbreeds	base/petbreeds
/organization/organization/geographic_scope	organization	organization
/language/human_language/countries_spoken_in	language	location
/aviation/aircraft_model/number_owned_by./aviation/aircraft_ownership_count/aircraft_owner	aviation	aviation
/user/robert/us_congress/us_representative/congressional_caucus_memberships	user/robert/us_congress	user/robert/us_congress
/education/educational_institution/campuses	education	education
/basketball/basketball_player/position_s	basketball	basketball
/business/board_member/leader_of./organization/leadership/role	business	organization
/sports/sport/leagues	sports	sports
/book/periodical/subjects	book	book
/martial_arts/martial_art/well_known_practitioner	martial_arts	martial_arts
/education/academic/advisees	education	education
/protected_sites/iucn_category/protected_areas	protected_sites	protected_sites
/astronomy/orbital_relationship/orbits	astronomy	astronomy
/music/group_member/artists_supported	music	music
/architecture/type_of_museum/museums	architecture	architecture
/sports/sports_team/sport	sports	sports
/fictional_universe/fictional_character/married_to./fictional_universe/marriage_of_fictional_characters/spouses	fictional_universe	fictional_universe
/education/educational_institution/sexes_accepted./education/gender_enrollment/sex	education	people
/film/actor/dubbing_performances./film/dubbing_performance/character	film	film
/tv/tv_actor/guest_roles./tv/tv_guest_role/special_performance_type	tv	tv
/venture_capital/venture_funded_company/venture_investors./venture_capital/venture_investment/investor	venture_capital	venture_capital
/symbols/name_source/namesakes	symbols	symbols
/award/award_winning_work/awards_won./award/award_honor/award_winner	award	award
/travel/transport_terminus/travel_destinations_served./travel/transportation/transport_terminus	travel	travel
/business/business_operation/operating_income./measurement_unit/dated_money_value/currency	business	finance
/base/crime/crime_victim/crime_type	base/crime	base/fight
/media_common/dedicated_work/dedication./media_common/dedication/dedicated_by	media_common	media_common
/cvg/game_voice_actor/computer_game_voice_performances./cvg/game_performance/game	cvg	cvg
/education/educational_degree/people_with_this_degree./education/education/institution	education	education
/military/military_combatant/casualties./military/casualties/military_conflict	military	military
/broadcast/broadcast/content	broadcast	broadcast
/organization/organization/companies_acquired./business/acquisition/company_acquired	organization	organization
/comic_books/comic_book_series/publisher	comic_books	comic_books
/religion/religion/organizations	religion	religion
/film/person_or_entity_appearing_in_film/films./film/personal_film_appearance/type_of_appearance	film	film
/base/americancomedy/impersonated_celebrity/impersonated_by	base/americancomedy	base/americancomedy
/base/aareas/schema/administrative_area/administrative_area_type	base/aareas/schema	base/aareas/schema
/tv/tv_program/seasons	tv	tv
/military/military_combatant/military_conflicts./military/military_combatant_group/conflict	military	military
/business/consumer_company/products./business/company_product_relationship/consumer_product	business	business
/business/asset_owner/assets_owned./business/asset_ownership/owned_asset	business	business
/dining/restaurant/cuisine	dining	dining
/user/alexander/philosophy/philosopher/era	user/alexander/philosophy	user/alexander/philosophy
/metropolitan_transit/transit_line/service_type	metropolitan_transit	metropolitan_transit
/fictional_universe/fictional_character/parents	fictional_universe	fictional_universe
/protected_sites/site_listing_category/listed_sites./protected_sites/natural_or_cultural_site_listing/listed_site	protected_sites	protected_sites
/film/actor/film./film/performance/film	film	film
/food/food/nutrients./food/nutrition_fact/nutrient	food	food
/geography/body_of_water/islands	geography	geography
/sports/sport/officials	sports	sports
/education/school_district/schools	education	education
/base/schemastaging/tv_character_extra/regular_dubbing_performances./base/schemastaging/tv_star_dubbing_performance/program	base/schemastaging	base/schemastaging
/religion/place_of_worship/religion	religion	religion
/aviation/airliner_accident/flight_destination	aviation	location
/education/field_of_study/academics_in_this_field	education	education
/fictional_universe/fictional_universe/works_set_here	fictional_universe	fictional_universe
/base/popstra/celebrity/wears./base/popstra/fashion_choice/designer	base/popstra	base/popstra
/ice_hockey/hockey_team/current_roster./sports/sports_team_roster/position	ice_hockey	sports
/broadcast/radio_station_owner/radio_stations	broadcast	broadcast
/tv/tv_writer/episodes_written	tv	tv
/film/film/personal_appearances./film/personal_film_appearance/person	film	film
/base/nobelprizes/nobel_prize_winner/nobel_honor./base/nobelprizes/nobel_honor/subject_area	base/nobelprizes	base/nobelprizes
/organization/organization/phone_number./common/phone_number/service_location	organization	location
/time/event/locations	time	location
/tv/tv_program/original_network./tv/tv_network_duration/network	tv	tv
/broadcast/radio_format/stations	broadcast	broadcast
/film/editor/film	film	film
/travel/travel_destination/local_transportation	travel	metropolitan_transit
/base/fight/crime_type/people_convicted_of_this_crime./base/crime/criminal_conviction/guilty_of	base/fight	base/fight
/travel/travel_destination/how_to_get_here./travel/transportation/transport_terminus	travel	travel
/dining/cuisine/restaurant	dining	dining
/sports/sport_country/athletic_performances./sports/competitor_competition_relationship/competitors	sports	sports
/location/statistical_region/rent50_4./measurement_unit/dated_money_value/currency	location	finance
/aviation/aircraft_model/aircraft_type	aviation	aviation
/film/film_distribution_medium/films_distributed_in_this_medium./film/film_film_distributor_relationship/film	film	film
/aviation/airline/alliance	aviation	aviation
/organization/role/leaders./organization/leadership/organization	organization	organization
/film/film/story_by	film	film
/visual_art/art_subject/artwork_on_the_subject	visual_art	visual_art
/comic_books/comic_book_character/regular_featured_appearances	comic_books	comic_books
/award/award_ceremony/awards_presented./award/award_honor/award_winner	award	award
/games/game_genre/boardgames	games	games
/law/judge/courts./law/judicial_tenure/court	law	law
/media_common/dedicated_work/dedication./media_common/dedication/dedicated_to	media_common	media_common
/award/ranked_item/appears_in_ranked_lists./award/ranking/list	award	award
/computer/programming_language/language_paradigms	computer	computer
/military/military_person/participated_in_conflicts	military	military
/geography/lake/lake_type	geography	geography
/royalty/noble_title/noble_rank	royalty	royalty
/government/legislative_session/members./government/government_position_held/district_represented	government	government
/military/military_combatant/force_deployments./military/force_strength/combatant	military	military
/film/film_subject/films	film	film
/transportation/bridge/bridge_type	transportation	transportation
/cvg/gameplay_mode/games_with_this_mode	cvg	cvg
/base/popstra/celebrity/friendship./base/popstra/friendship/participant	base/popstra	base/popstra
/symbols/namesake/named_after	symbols	symbols
/user/mt/default_domain/metabolite/biofluid_location	user/mt/default_domain	medicine
/base/schemastaging/organization_extra/phone_number./base/schemastaging/phone_sandbox/service_location	base/schemastaging	location
/cvg/computer_videogame/subjects	cvg	cvg
/film/film/dubbing_performances./film/dubbing_performance/language	film	language
/music/album/artist	music	music
/celebrities/celebrity/sexual_relationships./celebrities/romantic_relationship/celebrity	celebrities	celebrities
/cvg/computer_videogame/game_series	cvg	cvg
/tv/tv_program/subjects	tv	tv
/ice_hockey/hockey_position/players	ice_hockey	ice_hockey
/base/thoroughbredracing/thoroughbred_racehorse/country	base/thoroughbredracing	base/thoroughbredracing
/olympics/olympic_games/athletes./olympics/olympic_athlete_affiliation/country	olympics	olympics
/business/business_operation/retained_earnings./measurement_unit/dated_money_value/currency	business	finance
/architecture/structure/architectural_style	architecture	architecture
/food/ingredient/cuisine	food	dining
/film/film/personal_appearances./film/personal_film_appearance/type_of_appearance	film	film
/award/award_nominated_work/award_nominations./award/award_nomination/award_nominee	award	award
/tv/tv_location/tv_shows_filmed_here	tv	tv
/location/statistical_region/gni_per_capita_in_ppp_dollars./measurement_unit/dated_money_value/currency	location	finance
/geography/island_group/islands_in_group	geography	geography
/user/hangy/default_domain/sports_team_gender/gender	user/hangy/default_domain	people
/american_football/football_player/receiving./american_football/player_receiving_statistics/team	american_football	american_football
/education/fraternity_sorority/founded_location	education	education
/cvg/computer_videogame/developer	cvg	cvg
/baseball/baseball_player/lifetime_batting_statistics./baseball/lifetime_batting_statistics/ending_season	baseball	sports
/base/newsevents/news_reporting_organisation/news_reports./base/newsevents/news_report/event	base/newsevents	base/newsevents
/sports/pro_athlete/teams./sports/sports_team_roster/position	sports	sports
/organization/organization/board_members./organization/organization_board_membership/member	organization	business
/royalty/royal_line/monarchs_from_this_line	royalty	royalty
/base/petbreeds/dog_breed/color	base/petbreeds	base/petbreeds
/film/film_character/portrayed_in_films_dubbed./film/dubbing_performance/language	film	language
/sports/professional_sports_team/owner_s	sports	sports
/fictional_universe/fictional_character/employers./fictional_universe/fictional_employment_tenure/title	fictional_universe	fictional_universe
/broadcast/producer/produces	broadcast	broadcast
/business/business_operation/liabilities./measurement_unit/dated_money_value/currency	business	finance
/organization/non_profit_organization/registered_with./organization/non_profit_registration/registering_agency	organization	government
/award/award_category/category_of	award	award
/architecture/museum/address./location/mailing_address/state_province_region	architecture	location
/business/business_operation/current_assets./measurement_unit/dated_money_value/currency	business	finance
/royalty/chivalric_order_member/belongs_to_order./royalty/chivalric_order_membership/order	royalty	royalty
/film/film/executive_produced_by	film	film
/base/fight/crime_type/people_convicted_of_this_crime./base/crime/criminal_conviction/convicted_person	base/fight	base/crime
/royalty/monarch/kingdom	royalty	royalty
/base/ecology/ecosystem/ecosystem_members	base/ecology	base/ecology
/government/governmental_body/members./government/government_position_held/office_position_or_title	government	government
/royalty/noble_title/used_in./royalty/system_title_relationship/system	royalty	royalty
/location/country/official_language	location	language
/music/performance_role/regular_performances./music/group_membership/member	music	music
/user/radiusrs/default_domain/astrology/related_topics	user/radiusrs/default_domain	common
/people/place_of_interment/interred_here	people	people
/sports/sports_championship_event/championship	sports	sports
/film/film/release_date_s./film/film_regional_release_date/film_release_distribution_medium	film	film
/military/rank/used_by_services./military/military_service/military_person	military	military
/base/schemastaging/fish/found_in	base/schemastaging	base/schemastaging
/user/robert/us_congress/congressional_district/state	user/robert/us_congress	location
/sports/school_sports_team/school	sports	education
/location/country/administrative_divisions	location	location
/award/award_winner/awards_won./award/award_honor/honored_for	award	award
/people/appointee/position./people/appointment/appointed_role	people	people
/olympics/olympic_medal/medal_winners./olympics/olympic_medal_honor/medalist	olympics	olympics
/people/ethnicity/includes_groups	people	people
/base/contractbridge/bridge_tournament/standing./base/contractbridge/bridge_tournament_standings/second_place	base/contractbridge	base/contractbridge
/sports/sports_team/roster./soccer/football_roster_position/player	sports	soccer
/architecture/structure/address./location/mailing_address/citytown	architecture	location
/sports/sports_team/roster./american_football/football_historical_roster_position/player	sports	american_football
/sports/sports_team/roster./basketball/basketball_roster_position/player	sports	basketball
/sports/pro_athlete/teams./american_football/football_historical_roster_position/team	sports	american_football
/american_football/football_player/former_teams./american_football/football_historical_roster_position/position_s	american_football	american_football
/ice_hockey/hockey_player/current_team./sports/sports_team_roster/position	ice_hockey	sports
/baseball/baseball_player/current_team./sports/sports_team_roster/position	baseball	sports
/sports/sports_position/players./american_football/football_historical_roster_position/team	sports	american_football
/ice_hockey/hockey_player/current_team./ice_hockey/hockey_roster_position/team	ice_hockey	ice_hockey
/basketball/basketball_team/roster./basketball/basketball_roster_position/player	basketball	basketball
/architecture/structure/address./location/mailing_address/state_province_region	architecture	location
/sports/sports_position/players./soccer/football_roster_position/player	sports	soccer
/soccer/football_player/current_team./sports/sports_team_roster/team	soccer	sports
/sports/pro_athlete/teams./american_football/football_roster_position/team	sports	american_football
/ice_hockey/hockey_team/current_roster./ice_hockey/hockey_roster_position/player	ice_hockey	ice_hockey
/ice_hockey/hockey_player/current_team./ice_hockey/hockey_roster_position/position	ice_hockey	ice_hockey
/sports/sports_position/players./baseball/baseball_roster_position/team	sports	baseball
/baseball/baseball_player/former_teams./baseball/baseball_historical_roster_position/team	baseball	baseball
/sports/sports_team/roster./soccer/football_roster_position/position	sports	soccer
/soccer/football_player/current_team./soccer/football_roster_position/team	soccer	soccer
/american_football/football_team/current_roster./american_football/football_roster_position/position	american_football	american_football
/sports/sports_position/players./soccer/football_roster_position/team	sports	soccer
/ice_hockey/hockey_player/former_team_s./ice_hockey/hockey_previous_roster_position/team	ice_hockey	ice_hockey
/american_football/football_team/historical_roster./american_football/football_historical_roster_position/player	american_football	american_football
/basketball/basketball_player/team./basketball/basketball_roster_position/position	basketball	basketball
/sports/sports_position/players./american_football/football_roster_position/team	sports	american_football
/sports/sports_team/roster./baseball/baseball_roster_position/player	sports	baseball
/soccer/football_team/current_roster./soccer/football_roster_position/position	soccer	soccer
/american_football/football_player/former_teams./sports/sports_team_roster/position	american_football	sports
/sports/pro_athlete/teams./soccer/football_roster_position/position	sports	soccer
/american_football/football_player/current_team./sports/sports_team_roster/team	american_football	sports
/sports/sports_team/roster./american_football/football_roster_position/player	sports	american_football
/american_football/football_team/historical_roster./american_football/football_historical_roster_position/position_s	american_football	american_football
/basketball/basketball_team/historical_roster./basketball/basketball_historical_roster_position/player	basketball	basketball
/baseball/baseball_team/current_roster./baseball/baseball_roster_position/position	baseball	baseball
/sports/sports_team/roster./basketball/basketball_historical_roster_position/player	sports	basketball
/sports/sports_position/players./ice_hockey/hockey_roster_position/player	sports	ice_hockey
/american_football/football_position/players	american_football	american_football
/american_football/football_player/current_team./american_football/football_roster_position/team	american_football	american_football
/baseball/baseball_player/former_teams./sports/sports_team_roster/team	baseball	sports
/sports/sports_team/roster./american_football/football_historical_roster_position/position_s	sports	american_football
/sports/pro_athlete/teams./basketball/basketball_roster_position/team	sports	basketball
/basketball/basketball_player/former_teams./sports/sports_team_roster/team	basketball	sports
/baseball/baseball_team/historical_roster./baseball/baseball_historical_roster_position/player	baseball	baseball
/sports/pro_athlete/teams./baseball/baseball_roster_position/team	sports	baseball
/sports/pro_athlete/teams./ice_hockey/hockey_roster_position/position	sports	ice_hockey
/sports/sports_position/players./american_football/football_historical_roster_position/player	sports	american_football
/ice_hockey/hockey_team/historical_roster./ice_hockey/hockey_previous_roster_position/player	ice_hockey	ice_hockey
/basketball/basketball_player/team./basketball/basketball_roster_position/team	basketball	basketball
/sports/pro_athlete/teams./baseball/baseball_roster_position/position	sports	baseball
/sports/sports_position/players./basketball/basketball_roster_position/team	sports	basketball
/soccer/football_player/current_team./soccer/football_roster_position/position	soccer	soccer
/sports/sports_team/roster./basketball/basketball_roster_position/position	sports	basketball
/sports/sports_team/roster./ice_hockey/hockey_roster_position/position	sports	ice_hockey
/basketball/basketball_player/former_teams./basketball/basketball_historical_roster_position/team	basketball	basketball
/american_football/football_player/former_teams./american_football/football_historical_roster_position/team	american_football	american_football
/sports/sports_position/players./american_football/football_historical_roster_position/position_s	sports	american_football
/sports/pro_athlete/teams./ice_hockey/hockey_previous_roster_position/team	sports	ice_hockey
/soccer/football_team/current_roster./soccer/football_roster_position/player	soccer	soccer
/ice_hockey/hockey_player/current_team./sports/sports_team_roster/team	ice_hockey	sports
/sports/sports_position/players./baseball/baseball_roster_position/player	sports	baseball
/soccer/football_player/current_team./sports/sports_team_roster/position	soccer	sports
/sports/sports_position/players./ice_hockey/hockey_roster_position/team	sports	ice_hockey
/sports/pro_athlete/teams./american_football/football_historical_roster_position/position_s	sports	american_football
/baseball/baseball_player/current_team./baseball/baseball_roster_position/position	baseball	baseball
/basketball/basketball_team/roster./basketball/basketball_roster_position/position	basketball	basketball
/baseball/baseball_player/current_team./sports/sports_team_roster/team	baseball	sports
/sports/sports_team/roster./american_football/football_roster_position/position	sports	american_football
/american_football/football_player/former_teams./sports/sports_team_roster/team	american_football	sports
/sports/pro_athlete/teams./baseball/baseball_historical_roster_position/team	sports	baseball
/sports/pro_athlete/teams./ice_hockey/hockey_roster_position/team	sports	ice_hockey
/sports/pro_athlete/teams./basketball/basketball_historical_roster_position/team	sports	basketball
/american_football/football_team/current_roster./american_football/football_roster_position/player	american_football	american_football
/american_football/football_player/current_team./american_football/football_roster_position/position	american_football	american_football
/basketball/basketball_position/player_roster_position./basketball/basketball_roster_position/team	basketball	basketball
/basketball/basketball_player/team./sports/sports_team_roster/position	basketball	sports
/basketball/basketball_player/team./sports/sports_team_roster/team	basketball	sports
/sports/pro_athlete/teams./basketball/basketball_roster_position/position	sports	basketball
/ice_hockey/hockey_team/current_roster./ice_hockey/hockey_roster_position/position	ice_hockey	ice_hockey
/sports/sports_team/roster./baseball/baseball_historical_roster_position/player	sports	baseball
/baseball/baseball_player/current_team./baseball/baseball_roster_position/team	baseball	baseball
/sports/sports_team/roster./ice_hockey/hockey_roster_position/player	sports	ice_hockey
/baseball/baseball_team/current_roster./baseball/baseball_roster_position/player	baseball	baseball
/sports/pro_athlete/teams./soccer/football_roster_position/team	sports	soccer
/ice_hockey/hockey_player/former_team_s./sports/sports_team_roster/team	ice_hockey	sports
/sports/sports_team/roster./ice_hockey/hockey_previous_roster_position/player	sports	ice_hockey
/basketball/basketball_position/player_roster_position./basketball/basketball_roster_position/player	basketball	basketball
/sports/sports_position/players./basketball/basketball_roster_position/player	sports	basketball
/sports/sports_team/roster./baseball/baseball_roster_position/position	sports	baseball
/sports/pro_athlete/teams./american_football/football_roster_position/position	sports	american_football
